R 1500 1000

NO ./pics/bluestone.xpm
SO ./pics/colorstone.xpm
WE ./pics/wood.xpm
EA ./pics/redbrick.xpm
S ./pics/pillar.xpm

F 139,111,78
C 0,132,202

1111111111111111111111111111111111111111
1000000000202000000000000000000000000001
10S0001110000000100001000001100110000001
1000000000011111100011111111111111111101
102020202021   1000001               101
100000000001    10001                101
1000000000011111110111111111111111111101
1000000000000000000000000000000000000001
1020000000011111111111111110111111111101
100000000001              10001      101
100000000001             100001      101
1020202020211111111111111100011111111101
1000000000000000000000000000000000000001
1111111111111111111111111111111111111111