R 750 500

NO ./pics/wall_2.xpm
SO ./pics/wall_3.xpm
WE ./pics/wall_4.xpm
EA ./pics/wood.xpm
S ./pics/pillar.xpm

F 139,69,19
C 152,245,255

111111111111111111111111
100000000000000000000001
100000000000000000000001
100000000220202200000001
100000000210101200000001
100000000210101200000001
100000000220202200000001
10000000000N000000000001
111111111111111111111111