R 500 400

NO ./pics/bluestone.xpm
SO ./pics/colorstone.xpm
WE ./pics/wood.xpm
EA ./pics/redbrick.xpm
S ./pics/pillar.xpm

F 139,111,78
C 0,132,202

111111111111111111111111
100000000000000000000001
100000000000000000000001
100000000220202200000001
100000000210101200000001
10E000000210101200000001
100000000220202200000001
100000000000000000000001
111111111111111111111111